{
  "width": 16,
  "height": 16,
  "startX": 14,
  "startY": 8,
  "data": [
    4,4,4,4,4,4,4,4,4,4,4,4,4,4,4,4,
    4,0,0,0,0,0,0,0,0,0,0,0,0,0,0,4,
    4,0,0,0,0,0,0,0,0,0,0,0,0,0,0,4,
    4,0,0,0,0,0,0,0,0,0,0,0,0,0,0,4,
    4,0,3,5,2,0,0,0,0,0,0,0,0,0,0,4,
    4,0,0,0,0,0,0,0,0,0,0,0,0,0,0,4,
    4,0,0,0,0,0,0,0,0,0,0,0,0,0,0,4,
    4,0,1,0,0,0,0,0,0,0,0,0,0,0,0,4,
    4,0,0,0,0,0,0,0,0,0,0,0,0,0,0,4,
    4,0,0,0,0,0,0,0,0,0,0,0,0,0,0,4,
    4,0,0,0,0,6,0,0,0,6,0,0,0,0,0,4,
    4,0,0,0,0,6,0,0,0,6,0,0,0,0,0,4,
    4,0,0,0,0,6,0,0,0,6,0,0,0,0,0,4,
    4,0,0,0,0,6,0,0,0,6,0,0,0,0,0,4,
    4,0,0,0,0,6,0,0,0,6,0,0,0,0,0,4,
    4,4,4,4,4,4,4,4,4,4,4,4,4,4,4,4
  ]
}
